1111111111
1C0000P0C1
1011111111
100C0001E1
1000000001
1111111111
