11111111111111111111111111111111111111111111111111111111111111111111111111111111
1PCE0000000000000000000000000000000000000000000000000000000000000000000000000001
10000000000000000000000000000000000000000000000000000000000000000000000000000001
10000000000000000000000000000000000000000000000000000000000000000000000000000001
100CCCC0000000000000C00000000C00000000000000000000000000000000000000000000000001
100C00000000000000000C000000C000000000000000000000000000000000000000000000000001
100C00000000000000000C000000C000000C00000C000000C0000C0C000000000000000000000001
100C000000C000C0000000C0000C00000CC0CC0000C0000C0000C0CC000000000000000000000001
100CCC0000C000C0000000C0000C00000C000C0000C0000C000C000C000000000000000000000001
100C000000C000C00000000C00C000000CC0CC00000C00C00000C0CC000000000000000000000001
100C000000CCCCC000000000CC000000000C00000000CC0000000C0C000000000000000000000001
10000000000000000000000000000000000000000000000000000000000000000000000000000001
10000000000000000000000000000000000000000000000000000000000000000000000000000001
10000000000000000000000000000000000000000000000000000000000000000000000000000001
11111111111111111111111111111111111111111111111111111111111111111111111111111111
