1011111
1111101
1111111
1111111
