111111111111111111111111111111111111111111111111111111111111111111111
1EP000000000000000000000000000000000000000000000000000000000000000001
100111111100000000000000000000000000000000000000000000000000000000001
100C00010100000000000000000000000000000000000000000000000000000000001
100000010100000000000000000000000000000000000000000000000000000000001
111111111100000000000000000000000000000000000000000000000000000000001
1D0000000000000000000000000000000000000000000000000000000000000000001
1D0000000000000000000000000000000000000000000000000000000000000000001
1D0000000000000000000000000000000000000000000000000000000000000000001
111111111111111111111111111111111111111111111111111111111111111111111
