111111111111111111111111111111
1D00000000001001000000001D00C1
100000000000000100100000100001
100101010100000100100000100001
10010101010000000010D0000C0001
1001C101C100000000100000000001
100111010100000111111111000001
1001D101000010001000000C000001
1E0001C000001D0C11111111D000P1
111111111111111111111111111111
